{
  "tilemap": [
    [17, 17, 17, 17, 17, 17, 17, 17, 17, 17],
    [17, 17, 17, 17, 17, 17, 17, 17, 21, 17],
    [17, 17, 17, 17, 17, 17, 17, 17, 17, 17],
    [17, 17, 17, 19, 17, 17, 17, 17, 17, 17],
    [17, 13, 17, 21, 17, 11, 10, 17, 17, 17],
    [17, 15, 17, 17, 17, 17, 17, 17, 17, 17],
    [17, 17, 17, 17, 17, 17, 17, 17, 17, 21],
    [17, 17, 17, 17, 17, 17, 1, 7, 17, 17],
    [17, 17, 17, 17, 17, 17, 3, 9, 17, 17],
    [17, 17, 17, 17, 17, 17, 17, 17, 17, 17]
  ]
}
